"TX_MUNTY_COLLISION_NL","CD_NIS","CD_ROAD_TYPE_NL","_2017","_2018","_2019","_2020","_2022","_2021","Totaal"
"Aalst (Aalst)","41002","Gemeenteweg",1,1,1,1,2,0,6
"Aarlen","81001","Gemeenteweg",0,1,0,0,1,0,2
"Aarschot","24001","Gemeenteweg",0,0,2,2,0,1,5
"Aartselaar","11001","Gemeenteweg",0,0,2,0,0,1,3
"Aat","51004","Gemeenteweg",0,0,2,1,0,0,3
"Aiseau-Presles","52074","Gemeenteweg",0,2,1,0,0,0,3
"Amay","61003","Gemeenteweg",0,1,0,0,0,0,1
"Amel","63001","Gemeenteweg",1,0,0,1,0,0,2
"Andenne","92003","Gemeenteweg",0,0,0,1,1,0,2
"Anderlecht","21001","Gemeenteweg",2,0,2,3,1,0,8
"Anderlues","56001","Gemeenteweg",0,0,0,1,0,1,2
"Anhée","91005","Gemeenteweg",0,0,0,0,1,1,2
"Ans","62003","Gemeenteweg",1,0,1,0,0,1,3
"Antwerpen","11002","Gemeenteweg",9,5,4,5,6,12,41
"Ardooie","37020","Gemeenteweg",0,2,1,0,1,0,4
"As","71002","Gemeenteweg",0,0,0,1,0,0,1
"Asse","23002","Gemeenteweg",0,1,0,1,3,1,6
"Assenede","43002","Gemeenteweg",2,0,0,3,1,0,6
"Aubange","81004","Gemeenteweg",0,0,1,0,0,0,1
"Awans","62006","Gemeenteweg",0,0,0,1,0,0,1
"Aywaille","62009","Gemeenteweg",1,0,0,0,0,0,1
"Balen","13003","Gemeenteweg",1,1,0,1,2,0,5
"Beaumont","56005","Gemeenteweg",0,3,0,0,0,0,3
"Beauraing","91013","Gemeenteweg",1,1,2,0,0,0,4
"Beernem","31003","Gemeenteweg",2,0,0,1,0,0,3
"Beerse","13004","Gemeenteweg",1,0,0,0,0,1,2
"Beersel","23003","Gemeenteweg",1,0,1,0,1,1,4
"Begijnendijk","24007","Gemeenteweg",0,0,0,1,1,0,2
"Bekkevoort","24008","Gemeenteweg",0,0,1,0,0,0,1
"Beloeil","51008","Gemeenteweg",0,0,1,1,1,1,4
"Bergen","53053","Gemeenteweg",2,2,4,2,0,1,11
"Beringen","71004","Gemeenteweg",0,0,0,0,1,1,2
"Berlaar","12002","Gemeenteweg",0,0,0,0,1,1,2
"Berlare","42003","Gemeenteweg",1,0,0,0,1,0,2
"Bernissart","51009","Gemeenteweg",1,0,0,0,1,0,2
"Bertem","24009","Gemeenteweg",0,1,1,0,0,1,3
"Bertrix","84009","Gemeenteweg",2,1,0,1,0,2,6
"Beveren (Sint-Niklaas)","46003","Gemeenteweg",1,2,1,3,1,5,13
"Bilzen","73006","Gemeenteweg",0,1,1,0,0,0,2
"Binche","58002","Gemeenteweg",0,1,1,0,0,0,2
"Bitsingen","62011","Gemeenteweg",0,0,1,2,0,0,3
"Bièvre","91015","Gemeenteweg",0,0,1,0,0,0,1
"Blankenberge","31004","Gemeenteweg",0,1,0,0,1,0,2
"Blegny","62119","Gemeenteweg",0,1,0,1,0,0,2
"Bonheiden","12005","Gemeenteweg",0,0,0,0,1,0,1
"Boortmeerbeek","24014","Gemeenteweg",0,0,1,0,0,0,1
"Borgloon","73009","Gemeenteweg",2,0,0,0,1,0,3
"Borgworm","64074","Gemeenteweg",1,2,0,0,0,0,3
"Bornem","12007","Gemeenteweg",0,2,1,0,0,2,5
"Braives","64015","Gemeenteweg",0,0,0,0,0,1,1
"Brasschaat","11008","Gemeenteweg",0,0,1,0,1,1,3
"Brecht","11009","Gemeenteweg",0,0,0,0,0,1,1
"Bree","72004","Gemeenteweg",0,2,0,0,1,1,4
"Brugge","31005","Gemeenteweg",0,1,2,3,1,3,10
"Brunehaut","57093","Gemeenteweg",0,0,1,0,0,0,1
"Brussel","21004","Gemeenteweg",4,2,4,1,2,1,14
"Buggenhout","42004","Gemeenteweg",0,0,1,0,0,0,1
"Burg-Reuland","63087","Gemeenteweg",1,0,1,0,1,1,4
"Büllingen","63012","Gemeenteweg",0,0,1,0,0,0,1
"Bütgenbach","63013","Gemeenteweg",0,1,0,0,0,0,1
"Cerfontaine","93010","Gemeenteweg",1,0,0,0,0,0,1
"Chapelle-lez-Herlaimont","52010","Gemeenteweg",1,0,0,0,1,0,2
"Charleroi","52011","Gemeenteweg",2,2,3,8,5,1,21
"Chaudfontaine","62022","Gemeenteweg",0,0,0,0,0,1,1
"Chimay","56016","Gemeenteweg",0,1,1,0,1,1,4
"Chiny","85007","Gemeenteweg",0,0,1,0,0,0,1
"Chièvres","51014","Gemeenteweg",1,0,0,0,0,0,1
"Ciney","91030","Gemeenteweg",2,1,1,0,0,0,4
"Clavier","61012","Gemeenteweg",0,0,1,0,0,0,1
"Colfontaine","53082","Gemeenteweg",0,0,0,0,1,0,1
"Courcelles","52015","Gemeenteweg",1,0,0,0,1,0,2
"Court-Saint-Etienne","25023","Gemeenteweg",0,1,0,0,0,0,1
"Couvin","93014","Gemeenteweg",0,1,0,0,1,0,2
"Crisnée","64021","Gemeenteweg",0,0,0,0,0,1,1
"Dalhem","62027","Gemeenteweg",1,0,0,0,0,0,1
"Damme","31006","Gemeenteweg",0,2,3,1,1,0,7
"De Haan","35029","Gemeenteweg",0,1,0,0,0,0,1
"De Panne","38008","Gemeenteweg",1,0,0,0,0,0,1
"De Pinte","44012","Gemeenteweg",0,0,0,0,1,0,1
"Deerlijk","34009","Gemeenteweg",0,1,1,0,0,0,2
"Deinze","44083","Gemeenteweg",2,1,1,1,0,0,5
"Dendermonde","42006","Gemeenteweg",0,1,0,1,0,1,3
"Dentergem","37002","Gemeenteweg",2,0,0,2,0,1,5
"Dessel","13006","Gemeenteweg",0,0,1,0,0,0,1
"Destelbergen","44013","Gemeenteweg",1,0,1,0,0,2,4
"Diepenbeek","71011","Gemeenteweg",0,0,0,1,0,1,2
"Diest","24020","Gemeenteweg",0,0,2,0,0,0,2
"Diksmuide","32003","Gemeenteweg",0,2,0,0,0,0,2
"Dilbeek","23016","Gemeenteweg",0,0,1,1,0,0,2
"Dilsen-Stokkem","72041","Gemeenteweg",1,1,0,1,0,2,5
"Dinant","91034","Gemeenteweg",0,0,1,0,0,1,2
"Dison","63020","Gemeenteweg",0,2,0,0,0,0,2
"Doische","93018","Gemeenteweg",0,0,0,0,1,0,1
"Donceel","64023","Gemeenteweg",0,1,0,0,0,0,1
"Doornik","57081","Gemeenteweg",1,2,2,2,1,3,11
"Dour","53020","Gemeenteweg",1,0,0,0,2,0,3
"Duffel","12009","Gemeenteweg",0,0,1,0,0,0,1
"Ecaussinnes","55050","Gemeenteweg",0,1,0,0,0,0,1
"Edegem","11013","Gemeenteweg",0,1,0,0,0,1,2
"Edingen","51067","Gemeenteweg",0,1,0,0,0,0,1
"Eeklo","43005","Gemeenteweg",0,1,0,0,0,0,1
"Eigenbrakel","25014","Gemeenteweg",0,0,0,2,0,1,3
"Elsene","21009","Gemeenteweg",1,3,1,0,1,0,6
"Engis","61080","Gemeenteweg",0,0,1,0,0,0,1
"Erquelinnes","56022","Gemeenteweg",1,1,0,1,1,0,4
"Esneux","62032","Gemeenteweg",0,0,0,1,0,0,1
"Essen","11016","Gemeenteweg",0,0,1,0,1,0,2
"Estaimpuis","57027","Gemeenteweg",0,0,0,0,1,0,1
"Estinnes","58003","Gemeenteweg",0,0,0,1,0,0,1
"Eupen","63023","Gemeenteweg",0,1,0,0,1,0,2
"Evere","21006","Gemeenteweg",1,1,0,0,0,0,2
"Evergem","44019","Gemeenteweg",2,1,0,0,0,0,3
"Farciennes","52018","Gemeenteweg",1,0,0,0,1,0,2
"Fleurus","52021","Gemeenteweg",0,0,0,1,0,0,1
"Florennes","93022","Gemeenteweg",0,0,0,0,0,1,1
"Florenville","85011","Gemeenteweg",0,0,1,0,1,1,3
"Flémalle","62120","Gemeenteweg",2,0,2,0,0,0,4
"Fontaine-l’Evêque","52022","Gemeenteweg",0,0,1,0,0,0,1
"Fosses-la-Ville","92048","Gemeenteweg",0,0,0,1,0,0,1
"Frameries","53028","Gemeenteweg",0,1,0,0,1,0,2
"Frasnes-lez-Anvaing","51065","Gemeenteweg",0,0,0,1,0,0,1
"Froidchapelle","56029","Gemeenteweg",2,0,1,3,1,1,8
"Ganshoren","21008","Gemeenteweg",0,1,0,0,0,0,1
"Gavere","44020","Gemeenteweg",0,1,0,0,0,1,2
"Geel","13008","Gemeenteweg",1,0,1,2,0,2,6
"Geer","64029","Gemeenteweg",0,0,0,0,1,0,1
"Geetbets","24028","Gemeenteweg",0,0,1,0,0,1,2
"Geldenaken","25048","Gemeenteweg",0,0,1,0,0,0,1
"Gembloux","92142","Gemeenteweg",0,0,1,0,0,1,2
"Genepiën","25031","Gemeenteweg",0,0,1,0,0,0,1
"Genk","71016","Gemeenteweg",0,0,0,1,1,0,2
"Gent","44021","Gemeenteweg",1,1,2,6,4,6,20
"Geraardsbergen","41018","Gemeenteweg",1,1,0,0,1,0,3
"Gerpinnes","52025","Gemeenteweg",1,0,0,1,0,1,3
"Gesves","92054","Gemeenteweg",0,0,1,0,0,0,1
"Gooik","23024","Gemeenteweg",0,0,0,0,0,1,1
"Grimbergen","23025","Gemeenteweg",0,1,0,0,0,0,1
"Grobbendonk","13010","Gemeenteweg",0,0,0,1,1,1,3
"Grâce-Hollogne","62118","Gemeenteweg",0,1,0,0,0,0,1
"Haacht","24033","Gemeenteweg",0,0,1,0,0,0,1
"Haaltert","41024","Gemeenteweg",0,1,0,1,0,0,2
"Halen","71020","Gemeenteweg",0,0,0,0,0,1,1
"Halle (Halle-Vilvoorde)","23027","Gemeenteweg",1,0,0,0,0,0,1
"Ham","71069","Gemeenteweg",0,0,0,0,0,1,1
"Hamme (Dendermonde)","42008","Gemeenteweg",0,0,0,0,0,1,1
"Hamois","91059","Gemeenteweg",0,2,0,1,0,0,3
"Hamont-Achel","72037","Gemeenteweg",0,2,0,0,2,1,5
"Hannuit","64034","Gemeenteweg",0,0,0,0,1,0,1
"Harelbeke","34013","Gemeenteweg",0,2,0,1,1,0,4
"Hasselt","71022","Gemeenteweg",1,0,2,0,0,3,6
"Hastière","91142","Gemeenteweg",0,0,0,0,1,0,1
"Hechtel-Eksel","72038","Gemeenteweg",0,0,0,0,1,0,1
"Heers","73022","Gemeenteweg",0,0,0,1,0,0,1
"Heist-op-den-Berg","12014","Gemeenteweg",0,1,1,1,2,0,5
"Hemiksem","11018","Gemeenteweg",0,1,0,0,0,0,1
"Herbeumont","84029","Gemeenteweg",0,0,0,0,0,1,1
"Herent","24038","Gemeenteweg",0,1,0,0,0,0,1
"Herentals","13011","Gemeenteweg",0,0,1,0,0,1,2
"Herselt","13013","Gemeenteweg",1,0,0,0,0,1,2
"Herstal","62051","Gemeenteweg",0,0,0,1,0,2,3
"Herve","63035","Gemeenteweg",0,0,2,1,0,0,3
"Herzele","41027","Gemeenteweg",0,1,0,0,0,1,2
"Heusden-Zolder","71070","Gemeenteweg",0,2,0,1,0,1,4
"Heuvelland","33039","Gemeenteweg",0,1,0,0,0,0,1
"Hoegaarden","24041","Gemeenteweg",1,0,0,0,0,0,1
"Hoei","61031","Gemeenteweg",0,1,1,0,0,0,2
"Hoeilaart","23033","Gemeenteweg",0,0,0,0,1,1,2
"Holsbeek","24043","Gemeenteweg",0,0,0,1,0,0,1
"Hooglede","36006","Gemeenteweg",0,0,1,1,1,0,3
"Hoogstraten","13014","Gemeenteweg",0,1,0,0,1,0,2
"Houffalize","82014","Gemeenteweg",0,0,1,0,1,0,2
"Houthalen-Helchteren","72039","Gemeenteweg",1,0,1,2,2,0,6
"Houthulst","32006","Gemeenteweg",2,0,0,2,0,0,4
"Houyet","91072","Gemeenteweg",1,0,0,0,0,0,1
"Ichtegem","35006","Gemeenteweg",0,0,0,0,1,0,1
"Ieper","33011","Gemeenteweg",3,1,1,2,0,0,7
"Ingelmunster","36007","Gemeenteweg",1,0,0,0,0,0,1
"Itter","25044","Gemeenteweg",0,0,0,0,0,1,1
"Jabbeke","31012","Gemeenteweg",0,0,0,0,1,0,1
"Jalhay","63038","Gemeenteweg",0,0,0,0,1,0,1
"Jemeppe-sur-Sambre","92140","Gemeenteweg",0,2,0,0,0,0,2
"Jette","21010","Gemeenteweg",0,0,0,1,1,0,2
"Juprelle","62060","Gemeenteweg",0,0,0,0,1,0,1
"Jurbeke","53044","Gemeenteweg",1,1,0,0,0,0,2
"Kapelle-op-den-Bos","23039","Gemeenteweg",0,1,0,0,0,0,1
"Kapellen (Antwerpen)","11023","Gemeenteweg",0,1,1,0,0,0,2
"Kaprijke","43007","Gemeenteweg",0,0,1,0,0,0,1
"Kasteelbrakel","25015","Gemeenteweg",0,0,1,2,0,0,3
"Kasterlee","13017","Gemeenteweg",0,0,1,0,1,0,2
"Keerbergen","24048","Gemeenteweg",0,1,0,0,1,1,3
"Kelmis","63040","Gemeenteweg",1,0,0,0,0,0,1
"Kluisbergen","45060","Gemeenteweg",0,0,2,0,1,0,3
"Knokke-Heist","31043","Gemeenteweg",0,2,0,3,0,0,5
"Koekelberg","21011","Gemeenteweg",0,0,2,0,0,0,2
"Koksijde","38014","Gemeenteweg",0,1,0,0,0,0,1
"Komen-Waasten","57097","Gemeenteweg",0,1,0,2,1,2,6
"Kontich","11024","Gemeenteweg",0,0,0,0,1,0,1
"Kortemark","32011","Gemeenteweg",1,0,2,0,0,0,3
"Kortenaken","24054","Gemeenteweg",0,0,1,0,0,0,1
"Kortenberg","24055","Gemeenteweg",0,0,0,0,0,1,1
"Kortrijk","34022","Gemeenteweg",0,0,1,0,0,3,4
"Kraainem","23099","Gemeenteweg",0,0,1,0,0,0,1
"Kruibeke","46013","Gemeenteweg",0,0,0,1,0,1,2
"Kruisem","45068","Gemeenteweg",0,1,0,0,1,0,2
"Kuurne","34023","Gemeenteweg",0,1,0,0,0,0,1
"La Bruyère","92141","Gemeenteweg",0,0,1,0,0,0,1
"La Louvière","58001","Gemeenteweg",3,0,3,0,1,0,7
"La Roche-en-Ardenne","83031","Gemeenteweg",0,0,0,0,1,0,1
"Laakdal","13053","Gemeenteweg",0,0,1,0,0,0,1
"Lanaken","73042","Gemeenteweg",0,2,0,1,0,1,4
"Landen","24059","Gemeenteweg",1,0,1,0,0,0,2
"Langemark-Poelkapelle","33040","Gemeenteweg",0,1,1,1,0,0,3
"Le Roeulx","55035","Gemeenteweg",0,1,0,1,1,0,3
"Lebbeke","42011","Gemeenteweg",1,0,0,0,0,0,1
"Lendelede","34025","Gemeenteweg",1,0,0,0,0,0,1
"Lennik","23104","Gemeenteweg",1,0,0,0,0,0,1
"Lens","53046","Gemeenteweg",0,0,1,0,0,0,1
"Les Bons Villers","52075","Gemeenteweg",0,0,0,0,1,0,1
"Lessen","51069","Gemeenteweg",0,1,0,0,0,0,1
"Leuven","24062","Gemeenteweg",1,2,1,0,1,1,6
"Leuze-en-Hainaut","57094","Gemeenteweg",0,0,0,2,0,1,3
"Libin","84035","Gemeenteweg",0,0,1,0,1,0,2
"Libramont-Chevigny","84077","Gemeenteweg",0,1,1,0,0,0,2
"Lier","12021","Gemeenteweg",1,0,0,0,0,0,1
"Lierde","45063","Gemeenteweg",0,0,0,0,1,0,1
"Lievegem","44085","Gemeenteweg",1,0,0,0,1,0,2
"Lille","13019","Gemeenteweg",0,0,0,0,0,1,1
"Lobbes","56044","Gemeenteweg",0,0,2,0,1,0,3
"Lochristi","44034","Gemeenteweg",0,1,0,0,0,0,1
"Lokeren","46014","Gemeenteweg",1,1,0,3,0,1,6
"Lommel","72020","Gemeenteweg",1,1,0,0,1,2,5
"Londerzeel","23045","Gemeenteweg",0,0,1,0,0,1,2
"Lontzen","63048","Gemeenteweg",0,0,0,0,1,0,1
"Luik","62063","Gemeenteweg",4,2,2,4,1,3,16
"Lummen","71037","Gemeenteweg",0,0,1,0,0,0,1
"Léglise","84033","Gemeenteweg",0,0,0,0,0,1,1
"Maarkedal","45064","Gemeenteweg",0,0,0,1,0,0,1
"Maaseik","72021","Gemeenteweg",0,0,1,0,2,0,3
"Maasmechelen","73107","Gemeenteweg",1,2,1,0,1,1,6
"Maldegem","43010","Gemeenteweg",1,2,1,1,1,0,6
"Malmedy","63049","Gemeenteweg",0,0,1,1,1,0,3
"Manage","55086","Gemeenteweg",0,0,1,0,0,1,2
"Marchin","61039","Gemeenteweg",0,0,1,0,0,0,1
"Martelange","81013","Gemeenteweg",0,0,0,0,1,0,1
"Mechelen","12025","Gemeenteweg",0,0,1,0,1,0,2
"Meerhout","13021","Gemeenteweg",2,1,0,0,0,1,4
"Meise","23050","Gemeenteweg",0,2,0,0,0,0,2
"Meix-devant-Virton","85024","Gemeenteweg",0,0,0,0,1,0,1
"Menen","34027","Gemeenteweg",0,0,1,0,0,1,2
"Merbes-le-Château","56049","Gemeenteweg",0,0,1,0,0,0,1
"Merchtem","23052","Gemeenteweg",0,0,0,1,0,1,2
"Merksplas","13023","Gemeenteweg",0,0,1,0,0,0,1
"Messancy","81015","Gemeenteweg",1,0,0,0,0,1,2
"Mettet","92087","Gemeenteweg",1,0,0,0,0,0,1
"Meulebeke","37007","Gemeenteweg",0,1,0,0,1,0,2
"Middelkerke","35011","Gemeenteweg",1,0,0,1,1,2,5
"Modave","61041","Gemeenteweg",0,1,0,0,0,0,1
"Moeskroen","57096","Gemeenteweg",2,1,2,0,1,2,8
"Mol","13025","Gemeenteweg",1,1,0,1,1,0,4
"Moorslede","36012","Gemeenteweg",1,1,0,0,0,0,2
"Mortsel","11029","Gemeenteweg",0,1,0,0,0,0,1
"Namen","92094","Gemeenteweg",0,3,3,0,3,0,9
"Nassogne","83040","Gemeenteweg",0,1,0,0,0,0,1
"Nazareth","44048","Gemeenteweg",0,0,0,0,0,1,1
"Neufchâteau (Neufchâteau)","84043","Gemeenteweg",0,1,0,0,1,0,2
"Ninove","41048","Gemeenteweg",4,0,3,2,1,0,10
"Olen","13029","Gemeenteweg",0,0,1,0,0,1,2
"Olne","63057","Gemeenteweg",0,0,0,0,2,0,2
"Oostende","35013","Gemeenteweg",1,2,0,2,0,0,5
"Oosterzele","44052","Gemeenteweg",0,0,0,1,0,0,1
"Oostkamp","31022","Gemeenteweg",0,1,0,0,0,0,1
"Oostrozebeke","37010","Gemeenteweg",0,0,1,0,0,1,2
"Opwijk","23060","Gemeenteweg",1,0,0,0,0,0,1
"Orp-Jauche","25120","Gemeenteweg",0,1,0,0,1,0,2
"Oud-Heverlee","24086","Gemeenteweg",0,0,0,0,1,0,1
"Oudenaarde","45035","Gemeenteweg",0,2,2,0,1,0,5
"Oudenburg","35014","Gemeenteweg",0,0,1,0,0,1,2
"Oudsbergen","72042","Gemeenteweg",1,2,1,0,0,2,6
"Oupeye","62079","Gemeenteweg",0,0,1,0,0,0,1
"Overijse","23062","Gemeenteweg",1,0,0,0,0,0,1
"Paliseul","84050","Gemeenteweg",0,0,0,1,0,0,1
"Pecq","57062","Gemeenteweg",1,0,0,0,0,0,1
"Pelt","72043","Gemeenteweg",0,1,1,1,2,2,7
"Pepingen","23064","Gemeenteweg",0,0,0,1,0,0,1
"Perwijs (Nijvel)","25084","Gemeenteweg",0,0,0,1,0,0,1
"Philippeville","93056","Gemeenteweg",0,1,0,0,0,0,1
"Pont-à-Celles","52055","Gemeenteweg",0,0,0,1,1,0,2
"Poperinge","33021","Gemeenteweg",0,0,0,1,0,0,1
"Putte","12029","Gemeenteweg",1,0,0,1,0,2,4
"Puurs-Sint-Amands","12041","Gemeenteweg",0,0,1,0,0,0,1
"Péruwelz","57064","Gemeenteweg",1,1,0,0,0,0,2
"Quiévrain","53068","Gemeenteweg",0,0,0,1,0,1,2
"Ramillies","25122","Gemeenteweg",0,0,1,0,0,0,1
"Ranst","11035","Gemeenteweg",0,0,1,0,1,1,3
"Ravels","13035","Gemeenteweg",0,0,1,0,0,0,1
"Rebecq","25123","Gemeenteweg",0,0,0,0,1,0,1
"Riemst","73066","Gemeenteweg",0,1,0,0,0,0,1
"Rijkevorsel","13037","Gemeenteweg",1,0,0,0,0,0,1
"Rixensart","25091","Gemeenteweg",0,0,0,1,1,0,2
"Roeselare","36015","Gemeenteweg",1,0,1,0,1,0,3
"Ronse","45041","Gemeenteweg",1,0,0,0,0,0,1
"Roosdaal","23097","Gemeenteweg",0,0,1,0,0,1,2
"Rotselaar","24094","Gemeenteweg",1,0,1,0,0,0,2
"Rumst","11037","Gemeenteweg",0,0,0,1,1,0,2
"Saint-Georges-sur-Meuse","64065","Gemeenteweg",0,0,0,0,1,0,1
"Saint-Ghislain","53070","Gemeenteweg",0,0,2,0,0,0,2
"Saint-Nicolas (Luik)","62093","Gemeenteweg",0,2,2,0,0,1,5
"Sainte-Ode","82038","Gemeenteweg",0,1,0,0,0,0,1
"Sambreville","92137","Gemeenteweg",0,0,1,0,2,0,3
"Sankt Vith","63067","Gemeenteweg",0,1,0,0,0,1,2
"Schaarbeek","21015","Gemeenteweg",1,2,1,0,0,0,4
"Scherpenheuvel-Zichem","24134","Gemeenteweg",0,2,1,0,0,2,5
"Schilde","11039","Gemeenteweg",0,0,0,1,0,1,2
"Schoten","11040","Gemeenteweg",1,1,1,1,1,2,7
"Seneffe","55085","Gemeenteweg",1,0,0,0,0,1,2
"Seraing","62096","Gemeenteweg",0,1,0,0,2,1,4
"Sint-Genesius-Rode","23101","Gemeenteweg",1,0,0,1,0,0,2
"Sint-Gillis","21013","Gemeenteweg",0,1,0,0,0,0,1
"Sint-Gillis-Waas","46020","Gemeenteweg",1,1,1,0,0,2,5
"Sint-Joost-ten-Node","21014","Gemeenteweg",0,1,0,0,0,0,1
"Sint-Katelijne-Waver","12035","Gemeenteweg",0,0,0,0,2,1,3
"Sint-Lambrechts-Woluwe","21018","Gemeenteweg",2,0,0,0,0,0,2
"Sint-Laureins","43014","Gemeenteweg",1,1,0,0,0,0,2
"Sint-Martens-Latem","44064","Gemeenteweg",1,0,0,0,0,0,1
"Sint-Niklaas (Sint-Niklaas)","46021","Gemeenteweg",0,3,1,2,1,1,8
"Sint-Pieters-Leeuw","23077","Gemeenteweg",2,0,1,0,1,0,4
"Sint-Pieters-Woluwe","21019","Gemeenteweg",0,0,0,0,1,0,1
"Sint-Truiden","71053","Gemeenteweg",0,1,1,1,2,2,7
"Sivry-Rance","56088","Gemeenteweg",0,0,0,0,0,1,1
"Sombreffe","92114","Gemeenteweg",0,0,0,1,0,0,1
"Soumagne","62099","Gemeenteweg",0,0,1,0,0,0,1
"Spa","63072","Gemeenteweg",2,0,0,0,0,0,2
"Sprimont","62100","Gemeenteweg",0,0,0,0,0,1,1
"Stabroek","11044","Gemeenteweg",0,0,0,2,0,0,2
"Staden","36019","Gemeenteweg",0,0,1,0,1,0,2
"Stavelot","63073","Gemeenteweg",0,0,0,0,1,0,1
"Stekene","46024","Gemeenteweg",0,0,0,1,1,0,2
"Stoumont","63075","Gemeenteweg",0,1,1,0,0,1,3
"Temse","46025","Gemeenteweg",1,0,2,0,1,0,4
"Tessenderlo","71057","Gemeenteweg",0,0,0,0,1,1,2
"Theux","63076","Gemeenteweg",1,0,0,0,1,0,2
"Tielt (Tielt)","37015","Gemeenteweg",0,0,0,0,1,0,1
"Tienen","24107","Gemeenteweg",0,0,0,0,0,1,1
"Tongeren","73083","Gemeenteweg",1,0,1,0,0,0,2
"Torhout","31033","Gemeenteweg",0,1,0,0,0,1,2
"Trois-Ponts","63086","Gemeenteweg",0,1,0,0,0,0,1
"Tubeke","25105","Gemeenteweg",0,0,0,0,1,0,1
"Turnhout","13040","Gemeenteweg",1,0,1,0,0,0,2
"Ukkel","21016","Gemeenteweg",1,0,0,0,0,0,1
"Verviers","63079","Gemeenteweg",1,0,0,0,1,1,3
"Veurne","38025","Gemeenteweg",1,0,0,1,0,0,2
"Vielsalm","82032","Gemeenteweg",0,1,1,0,0,0,2
"Villers-la-Ville","25107","Gemeenteweg",0,1,0,0,1,0,2
"Vilvoorde","23088","Gemeenteweg",0,0,0,1,0,0,1
"Viroinval","93090","Gemeenteweg",1,0,0,0,0,0,1
"Virton","85045","Gemeenteweg",1,1,0,0,0,0,2
"Vloesberg","51019","Gemeenteweg",0,0,0,0,1,0,1
"Voeren","73109","Gemeenteweg",1,0,0,0,0,0,1
"Vorselaar","13044","Gemeenteweg",0,0,1,0,0,1,2
"Vosselaar","13046","Gemeenteweg",2,0,0,0,0,0,2
"Walcourt","93088","Gemeenteweg",0,0,0,0,1,0,1
"Walhain","25124","Gemeenteweg",0,0,0,0,0,1,1
"Wanze","61072","Gemeenteweg",0,0,1,1,1,0,3
"Waregem","34040","Gemeenteweg",1,1,2,0,0,1,5
"Waver","25112","Gemeenteweg",1,0,1,0,0,0,2
"Weismes","63080","Gemeenteweg",0,0,1,0,0,0,1
"Welkenraedt","63084","Gemeenteweg",0,0,1,0,0,0,1
"Wellen","73098","Gemeenteweg",0,0,1,0,0,0,1
"Wemmel","23102","Gemeenteweg",0,1,1,0,1,0,3
"Wervik","33029","Gemeenteweg",0,1,0,1,1,0,3
"Westerlo","13049","Gemeenteweg",1,1,1,0,1,1,5
"Wetteren","42025","Gemeenteweg",0,0,1,1,0,0,2
"Wevelgem","34041","Gemeenteweg",2,1,0,1,0,0,4
"Wichelen","42026","Gemeenteweg",1,0,0,0,0,0,1
"Wielsbeke","37017","Gemeenteweg",0,0,1,1,1,0,3
"Wijnegem","11050","Gemeenteweg",1,0,0,0,1,0,2
"Willebroek","12040","Gemeenteweg",0,1,3,1,0,0,5
"Wingene","37018","Gemeenteweg",0,0,0,1,0,0,1
"Wommelgem","11052","Gemeenteweg",0,2,0,1,0,0,3
"Wortegem-Petegem","45061","Gemeenteweg",0,0,0,0,0,1,1
"Wuustwezel","11053","Gemeenteweg",0,0,1,0,0,2,3
"Zandhoven","11054","Gemeenteweg",0,0,0,2,0,0,2
"Zaventem","23094","Gemeenteweg",1,0,0,0,1,0,2
"Zedelgem","31040","Gemeenteweg",0,0,0,0,1,0,1
"Zele","42028","Gemeenteweg",1,2,0,1,0,0,4
"Zinnik","55040","Gemeenteweg",1,1,0,0,0,0,2
"Zonhoven","71066","Gemeenteweg",0,0,0,1,0,1,2
"Zonnebeke","33037","Gemeenteweg",0,0,2,0,1,1,4
"Zottegem","41081","Gemeenteweg",0,1,1,2,0,0,4
"Zoutleeuw","24130","Gemeenteweg",0,0,0,2,0,1,3
"Zwevegem","34042","Gemeenteweg",1,0,1,1,1,0,4
"Zwijndrecht","11056","Gemeenteweg",0,0,0,0,0,1,1
